Date varchar(50),	
Country varchar(50),	
Pin_Code varchar(50),	
Gender varchar(10),
career_aspirations_influences varchar(50),
pursue_education_outside_of_India_if_sponsored? varchar(50),	
work_for_one_employer_3_years_or_more varchar(50),	
work_for_a_company_whose_mission_is_not clearly_defined? varchar(50),	
work_for_a_company_whose_mission_is_misaligned?	varchar(50),
work_for_a_company_whose_mission_is-not_bringing_social_impact varchar(50),	
preferred_working_environment?	varchar(50),
Preferred_Employers?	varchar(50),
Preferred_learning_environment?	varchar(50),
Aspirational_job varchar(50),
Preferred_Manager_type?	
setup_you_would_like_to_work varchar(50),	
work_for_a_company_that_has_LaidOff_Employees_recently varchar(50),	
work_for_one_employer_for_7_years_or_more varchar(50),	
Email_address	varchar(50),
minimum_expected_monthly_salary_for_first_3_years varchar(50),	
minimum_expected_monthly_salary_for_first_5_years varchar(50),	
work_for_a_company_that_has_NO_REMOTE_working_policy varchar(50),	
minimum_expectations_of_salary_as_fresher? varchar(50),	
Preferred_company varchar(50),	
work_under_abusive_manager varchar(50),	
hours_would_you_be_willing_to_work_every_day varchar(50),	
full_week_break_for_work_life_balance varchar(50),	
What_would_make_you_happier_and_productive_at_work varchar(50)	
What_would_frustrate_you_at_work varchar(100)
